杭州灵隐-飞来峰电子门票系统	财资管理云平台-投融资管理系统开发项目
杭州公园IC年卡系统	广州农商银行模糊匹配平台项目
苏州拙政园电子门票管理系统	2017年直销银行系统优化项目第一批次-2017年直销银行系统优化项目
杭州市民卡公园应用系统	昆仑银行人行302号文监管账户分类项目-直销银行系统开发改造项目
千岛湖电子门票智能管理系统	店中店项目（二期）
安徽黄山风景区电子门票智能管理系统	行E通整合项目（三期）
乐青雁荡山风景区电子门票智能管理系统	基金一账通人人金服、链家宝项目
奉化溪口露天弥勒大佛风景区电子门票系统	ABS项目
杭州印象西湖电子门票管理系统	昆仑银行信用卡项目-直销银行子项目
苏州虎丘景区电子门票智能管理系统	行E通整合项目（二期）
河北白洋淀电子门票管理系统	店中店项目
印象野三坡电子门票管理系统	平安租赁培训信息管理系统项目
内蒙古响沙湾景区电子门票管理系统	闲钱宝软件开发
河北老界岭电子门票智能管理系统	行E通整合项目
雁荡山旅游电子商务管理系统	平安信托产品客户权益登记系统、产品信息管理系统研发项目
承德避暑山庄卡综合管理系统	大道推客二期开发项目
普陀山景区自助售票系统	金服软件开发合同
四川九寨沟电子门票智能管理系统	财资管理云平台-投融资管理系统开发项目
河南尧山电子门票智能管理系统	广州讯猫外包服务项目
苏州留园景区电子门票智能管理系统	P2P平台外包服务人月框架协议
洛阳龙门石窟景区电子门票	上海尔凌外包服务项目
苏州乐园电子门票智能管理系统	平安科技服务项目
苏州西山旅游区年卡管理系统	平安财产保险服务项目
杭州雷峰塔景区自助售检票系统	昆仑银行服务项目
杭州宋城主题公园电子门票智能管理系统	广州农村商业银行人力外包项目
宁波凤凰山主题乐园电子门票管理系统	闲钱宝平台外包服务人月结构协议
杭州西溪湿地景区电子门票智能管理系统	招银云创IT人力外包项目
江苏镇江金山公园电子门票智能管理系统	陆金所外包服务项目
江苏宜兴龙背山森林公园年卡管理系统	大道金融外包服务项目
苏州乐园园内收费管理系统	亿账通外包服务项目
宋城剧院票务管理系统	金服人力外包合作框架协议
杭州城隍阁停车场收费管理系统	大道金服外包服务项目
江苏泰州溙湖国家湿地公园电子门票智能管理系统	广发基金管理有限公司外包服务项目
临安大明山旅游电子门票智能管理系统	博时基金管理有限公司外包服务项目
绍兴文旅集团电子门票智能管理系统	平安金融+亿账通外包服务项目
绍兴文旅集团电子商务系统	平安综合金融服务项目
江南会会员管理系统	大成基金外包服务项目
嘉兴旅游馆电子门票智能管理系统	招商基金合作项目
宁波大桥生态农庄智能管理系统	人事服务项目
杭州宋城主题乐园电子门票系统	广州农村商业银行不限系统通用平台类项目
江南天池电子门票智能管理系统	招商银行数字资产证券化OTC交易系统项目
江南天池滑雪场电子门票管理系统	招商银行IT研发外包服务项目
文成百丈景区电子门票管理系统	招商银行对公开户旅程改造项目
宁波东钱湖景区电子门票智能管路系统	无限极软件开发项目
苏州青少年宫活动中心电子门票管理系统	广发证券人力外包服务项目
江苏穆墩岛电子门票管理系统	平安综合金融服务项目
无锡梁鸿湿地电子门禁管理系统	招商银行IT研发外包服务项目
山东烟台文体中心剧院电子门票管理系统	南方基金外包服务项目
青岛奥帆中心电子门票管理系统	招商银行金融市场SmarTrade系统项目
铃兰水底世界电子门票智能管理系统	招商银行太原分行软件开发外包项目
青岛宝龙乐园电子门票及智能排队管理系统	碧桂园物业技术开发服务项目
杭州宋城旅游电子商务系统平台	平安银行信托财富管理项目
江苏常州淹城公园停车场管理系统	深圳市房多多外包服务项目
青岛啤酒博物馆电子门票管理系统	深鹏达电网科技外包服务项目
苏州白马涧生态旅游景区年卡管理系统	万惠金融外包服务项目
宁波雅戈尔动物园电子门票管理系统	昆仑健康外包服务项目
海南三亚三特索道电子门票管理系统	平安财产保险服务产品运营项目
常州春秋淹池电子门票管理系统	无限极软件开发项目
湖北十堰市一卡通管理系统	智布互联外包服务项目
青岛奥帆中心一卡通管理系统	威海蓝海大屏展示系统项目
湖北神农架景区电子门票一卡通系统	招商银行IT人力外包项目
四川蜀南竹海数字化景区建设管理系统	南方基金外包服务项目
无锡市动物园电子问票系统	平安综合金融服务项目
宁波杭州湾湿地公园电子门票智能管理系统	招商银行港中旅跨境巴士项目
苏州乐园水上世界景区全面信息化管理系统	北京安御道合外包服务项目